WWWWWWWWWWWWWWWWWWWWWWWWWWWWWWWWW
W...............................W
W..P............................W
W...............................W
W............O...O..............W
W...............................W
W...........................G...W
W...............................W
WWWWWWWWWWWWWWWWWWWWWWWWWWWWWWWWW