WWWWWWWWW
W........WWW
W.........P.WWW
W..............W
W......WWWWWWWWW
W..............W
W............G.W
W...O..........W
W..............W
WWWWWWWWWWWWWWWW